# Syntax Coloring Map For Melopero_UBX

# Datatypes (KEYWORD1)
UbxMessage  KEYWORD3
PVTData KEYWORD3

# Methods and Functions (KEYWORD2)
msgClassToString	KEYWORD2
getGNSSFixType	KEYWORD2
computeChecksum	KEYWORD2
resetPayload	KEYWORD2
ubxMessageToString	KEYWORD2

# Instances (KEYWORD2)
# UbxMessage
msgClass	KEYWORD2
msgId	KEYWORD2
length	KEYWORD2
payload KEYWORD2
checksumA	KEYWORD2
checksumB	KEYWORD2

# PVTData
itow	KEYWORD2
year	KEYWORD2
month	KEYWORD2
day	KEYWORD2
hour	KEYWORD2
min	KEYWORD2
sec	KEYWORD2
validTimeFlag	KEYWORD2
timeAccuracy	KEYWORD2
nano	KEYWORD2
fixType	KEYWORD2
fixStatusFlags	KEYWORD2
additionalFlags	KEYWORD2
numberOfSatellites	KEYWORD2
longitude	KEYWORD2
latitude	KEYWORD2
height	KEYWORD2
hMSL	KEYWORD2
horizontalAccuracy	KEYWORD2
verticalAccuracy	KEYWORD2
velocityNorth	KEYWORD2
velocityEast	KEYWORD2
velocityDown	KEYWORD2
groundSpeed	KEYWORD2
headingOfMotion	KEYWORD2
speedAccuracy	KEYWORD2
headingAccuracy	KEYWORD2
positionDOP	KEYWORD2
reserved	KEYWORD2
headingOfVehicle	KEYWORD2
magneticDeclination	KEYWORD2
declinationAccuracy	KEYWORD2

# Constants (LITERAL1)
NAV_CLASS	LITERAL1
RXM_CLASS	LITERAL1
INF_CLASS	LITERAL1
ACK_CLASS	LITERAL1
CFG_CLASS	LITERAL1
UPD_CLASS	LITERAL1
MON_CLASS	LITERAL1
AID_CLASS	LITERAL1
TIM_CLASS	LITERAL1
ESF_CLASS	LITERAL1
MGA_CLASS	LITERAL1
LOG_CLASS	LITERAL1
SEC_CLASS	LITERAL1
HNR_CLASS	LITERAL1

SYNC_CHAR_1	LITERAL1
SYNC_CHAR_2	LITERAL1

#********* NAV MESSAGE SECTION **********
NAV_PVT	LITERAL1

#********* ACK MESSAGE SECTION **********
ACK_ACK	LITERAL1
ACK_NAK	LITERAL1

#********* CFG MESSAGE SECTION **********
CFG_PRT	LITERAL1
CFG_MSG	LITERAL1
CFG_RATE	LITERAL1

#********* FixTypes SECTION **********
NO_FIX	LITERAL1
DEAD_RECKONING_ONLY	LITERAL1
TWO_D_FIX	LITERAL1
THREE_D_FIX	LITERAL1
GNSS_DEAD_RECKONING_COMBINED	LITERAL1
TIME_ONLY_FIX	LITERAL1

#******* DEBUG/HELPING CONSTANTS ********
MAX_MESSAGE_LENGTH	LITERAL1
